R 640 480
F 255,100,100
C 100,100,255

NO textures/blue stone.png
SO textures/redbrick.png
WE textures/colorstone.png
EA textures/ea gle.png

S textures/pillar.png

        1111111111111111111111111
        1000000000110000000000001
        1011000001110000002000001
        1001000000000000000000001
111111111011000001110000000000001
100000000011000001110111111111111
11110111111111011100000010001
11110111111111011101010012001
11000000110101011100000010001
10002000000000001100000000001
10000000000000001101010010001
11000001110101011111011110W0111
11110111 1110101 101111010001
11111111 1111111 111111111111
