R 1337 1100
NO ./textures/bluestone.xpm
SO ./textures/bluestone.xpm
WE ./textures/wood.xpm
EA ./textures/wood.xpm

S  ./textures/pillar.xpm

F 184,113,39
C 51,198,227

        1111111111111111111111111
        1200000000110000000111011
        1011000001110000000110001
        1001000000000000000110001
111111111011000001110000000000001
120000000011000001110111111111111
11110111111111011100000010001
11110111111111011101010010001
11000000110101011100000010001
10000000000000001100000000001
12000000000000001101010010001
11000001110101011111011110N0111
12110111 1110101 101111010021
11111111 1111111 111111111111